20 30
******************************
*          @                 *
*     @    @                 *
*     @    @     @           *
*     @          @           *
*     @   @      @           *
*     @   @   @  @           *
*         @   @      @@@@@@  *
*             @              *
* @@@@  @                    *
*       @      @@@@   @@@    *
*       @                    *
*       @                    *
*       @                    *
*       @                    *
*                            *
*                            *
*                            *
*                            *
******************************

