20 30
******************************
*                            *
*      @@@@@@      @@        *
*     @              @       *
*     @              @       *
*     @   @          @       *
*  @@@    @   @ @@@@ @       *
*         @   @       @@@@@  *
*             @              *
*                            *
* @@@@@@   @@@@@@   @@@@@@   *
*       @           @        *
*       @@   @@@@@@@@        *
*       @           @        *
*       @           @        *
*                            *
*                            *
*                            *
*                            *
******************************

