20 50
**************************************************
*           @                   @                *
*@@ @@@ @@@ @ @@@@@@@@@@@@@@@@@ @ @@@@@@@@@@@@@@@*
*           @                 @ @                *
*@@ @@@ @@@ @ @@@ @@@@ @@@ @@ @ @ @ @@@@@@@@@@@@ *
*    @   @@ @ @@@             @ @ @            @ *
* @  @ @ @@ @ @@@ @@@@@@@ @@@ @ @ @ @@ @@@@@@@ @ *
* @ @@ @ @@ @ @@              @ @ @ @            *
*                @@@ @@@@@@@@@  @     @@ @@@@@@@ *
*@@@@@@@@@@@@@ @ @@@ @   @@@ @ @ @@@@ @@ @     @ *
*              @ @@@ @ @  @@ @ @      @@ @ @@@ @ *
* @@ @@ @@@@@@ @ @@@ @ @@ @@   @ @@@ @@@ @ @ @ @ *
*           @@ @ @@@ @ @@ @@@ @@         @ @ @ @ *
* @@ @@ @@@ @@ @ @@@ @ @@ @@  @ @ @@@@@@ @ @ @ @ *
*           @  @                         @ @   @ *
* @@ @@ @@@ @ @@@@@@@@@@@@@@@@ @@ @@ @ @ @ @@@@@@*
*           @                        @ @         *
* @@ @@ @@@ @ @ @@@@@@@@@@@@@@@@@@@@ @ @ @@@@@@@ *
*             @ @                    @           *
**************************************************
