21 40
****************************************
*   @ @ @ @@ @       @ @@    @   @@@@  *
* @ @   @ @@ @ @@@@@ @ @  @@ @ @       *
*@  @ @ @ @@ @ @@@@@ @ @@@@@ @ @ @@@@@@*
*@ @@        @ @@@@@ @       @ @       *
*     @@ @@@ @       @ @ @@@@@ @ @@@ @@*
* @ @ @@ @@@ @@@@ @@@@ @       @ @@  @ *
* @ @           @ @    @ @@@@@@@    @@ *
* @ @ @ @ @@@@@ @ @ @@ @         @@    *
* @ @@@@@       @ @ @@ @ @@@@@@@ @@@ @@*
* @       @@@@@     @@ @ @@@     @   @ *
* @@ @@@@ @@@@@ @ @ @        @ @   @ @ *
*               @ @ @ @@@ @@ @ @@@ @ @ *
*@@@ @@@  @@@@ @@ @ @ @@@ @@       @ @ *
* @@ @ @                  @@ @@ @@ @ @ *
* @  @ @ @@@@@@@@ @@ @@ @ @@ @@      @ *
* @ @@ @        @ @  @@ @ @@ @@ @@@@ @ *
*      @ @@ @@@@@ @ @@                 *
*@@ @@@@ @@            @@@@ @@@@ @@@@@ *
*           @@@   @@@@                 *
****************************************
